const short Level_1_map[19][20] = {
{ 1, 1, 1, 9, 1, 1, 1, 1, 1, 9, 1, 1, 1, 1, 1, 9, 1, 1, 1, 1 },
{ 1, 1, 1, 0, 1, 1, 1, 1, 1, 0, 1, 1, 1, 1, 1, 0, 1, 1, 1, 1 },
{ 1, 1, 1, 0, 1, 1, 1, 1, 1, 0, 1, 1, 1, 1, 1, 0, 1, 1, 1, 1 },
{ 1, 1, 1, 0, 1, 1, 1, 1, 1, 0, 1, 1, 1, 1, 1, 0, 1, 1, 1, 1 },
{ 1, 1, 1, 0, 1, 1, 1, 1, 1, 0, 1, 1, 1, 1, 1, 0, 1, 1, 1, 1 },
{ 1, 1, 1, 0, 1, 1, 1, 1, 1, 0, 1, 1, 1, 1, 1, 0, 1, 1, 1, 1 },
{ 1, 1, 1, 0, 1, 1, 1, 1, 1, 0, 1, 1, 1, 1, 1, 0, 1, 1, 1, 1 },
{ 1, 1, 1, 0, 1, 1, 1, 1, 1, 0, 1, 1, 1, 1, 1, 0, 1, 1, 1, 1 },
{ 1, 1, 1, 3, 0, 0, 0, 0, 0, 5, 1, 1, 1, 1, 1, 0, 1, 1, 1, 1 },
{ 1, 1, 1, 1, 1, 1, 1, 1, 1, 0, 1, 1, 1, 1, 1, 0, 1, 1, 1, 1 },
{ 1, 1, 1, 1, 1, 1, 1, 1, 1, 0, 1, 1, 1, 1, 1, 0, 1, 1, 1, 1 },
{ 1, 1, 1, 1, 1, 1, 1, 1, 1, 3, 0, 0, 0, 0, 0, 5, 1, 1, 1, 1 },
{ 1, 1, 1, 1, 1, 1, 1, 1, 1, 1, 1, 1, 1, 1, 1, 0, 1, 1, 1, 1 },
{ 1, 1, 1, 1, 1, 1, 1, 1, 1, 1, 1, 1, 1, 1, 1, 0, 1, 1, 1, 1 },
{ 1, 1, 1, 1, 1, 1, 1, 1, 1, 1, 1, 1, 1, 1, 1, 0, 1, 1, 1, 1 },
{ 1, 1, 10, 0, 0, 0, 0, 0, 0, 0, 0, 0, 0, 0, 0, 4, 1, 1, 1, 1 },
{ 1, 1, 1, 1, 1, 1, 1, 1, 1, 1, 1, 1, 1, 1, 1, 1, 1, 1, 1, 1 },
{ 1, 1, 1, 1, 1, 1, 1, 1, 1, 1, 1, 1, 1, 1, 1, 1, 1, 1, 1, 1 },
{ 1, 1, 1, 1, 1, 1, 1, 1, 1, 1, 1, 1, 1, 1, 1, 1, 1, 1, 1, 1 }
};

const unsigned short Level_1_cmap[256] = {
0x0000, 0x7C80, 0x3009, 0x0372, 0x0000, 0x5FC0, 0x4409, 0x013B,
0x26EA, 0x0000, 0x0000, 0x0000, 0x0000, 0x4880, 0x001B, 0x0000,
0x0000, 0x0000, 0x2800, 0x012F, 0x0000, 0x6820, 0x0009, 0x0000,
0x2775, 0x61A0, 0x1409, 0x0138, 0x2749, 0x6AA0, 0x4809, 0x036F,
0x25E6, 0x0000, 0x5800, 0x0137, 0x0000, 0x0000, 0x0000, 0x0000,
0x0000, 0x0000, 0x0000, 0x0000, 0x0000, 0x0000, 0x3400, 0x013A,
0x26EE, 0x0000, 0x5400, 0x0372, 0x0000, 0x0000, 0x0000, 0x0000,
0x6E77, 0x6060, 0x5409, 0x0138, 0x0000, 0x6140, 0x0009, 0x0000,
0x0000, 0x4E00, 0x081B, 0x0137, 0x0000, 0x44E0, 0x141B, 0x013B,
0x0000, 0x68A0, 0x2809, 0x012E, 0x2741, 0x0000, 0x0000, 0x0000,
0x2741, 0x6920, 0x7C09, 0x0372, 0x6E47, 0x4A40, 0x081B, 0x0137,
0x0000, 0x0000, 0x1800, 0x0372, 0x0000, 0x4BC0, 0x0C1B, 0x0372,
0x0000, 0x6F20, 0x5409, 0x013A, 0x6DF5, 0x0000, 0x2000, 0x0372,
0x276D, 0x0000, 0x4400, 0x0138, 0x2771, 0x0000, 0x7800, 0x0372,
0x6E4E, 0x3A80, 0x1409, 0x013A, 0x26E2, 0x51E0, 0x341B, 0x0372,
0x0000, 0x5CC0, 0x6C09, 0x0138, 0x26F6, 0x0000, 0x0000, 0x0000,
0x271C, 0x0000, 0x0000, 0x0000, 0x6E75, 0x0000, 0x7000, 0x0373,
0x6E52, 0x0000, 0x3C00, 0x0137, 0x0000, 0x5DC0, 0x4809, 0x0136,
0x2751, 0x48A0, 0x6C1B, 0x0372, 0x270C, 0x0000, 0x4400, 0x0372,
0x6E40, 0x4C60, 0x241B, 0x013A, 0x26FA, 0x4820, 0x5C1B, 0x012F,
0x0000, 0x5FC0, 0x5C09, 0x0372, 0x6E72, 0x6A20, 0x0009, 0x0000,
0x0000, 0x38A0, 0x6809, 0x0373, 0x6E55, 0x3FE0, 0x0409, 0x013A,
0x0000, 0x4960, 0x281B, 0x0137, 0x0000, 0x0000, 0x0000, 0x0000,
0x26F6, 0x4D60, 0x641B, 0x0372, 0x275D, 0x0000, 0x2000, 0x0373,
0x2710, 0x3C40, 0x0009, 0x0000, 0x6E56, 0x6A20, 0x0009, 0x0000,
0x0000, 0x0000, 0x4400, 0x013A, 0x25FA, 0x0000, 0x0000, 0x0000,
0x2765, 0x0000, 0x0000, 0x0000, 0x6E4A, 0x0000, 0x0000, 0x0000,
0x0000, 0x0000, 0x0000, 0x0000, 0x26EE, 0x47C0, 0x001B, 0x0000,
0x0000, 0x4A60, 0x001B, 0x0000, 0x2741, 0x0000, 0x0000, 0x0000,
0x0000, 0x5E80, 0x0009, 0x0000, 0x6E50, 0x0000, 0x0000, 0x0000,
0x6E49, 0x0000, 0x7800, 0x0136, 0x6DEF, 0x69A0, 0x6809, 0x0372,
0x6E54, 0x0000, 0x0000, 0x0000, 0x0000, 0x6B20, 0x0009, 0x7FFF
};

